WWWWWWWWWWWWWWWWWWWW
W....F...WW....WWG.W
W.WWWWWW.W..WFWWWW.W
W.W...W..W.WW.W....W
W.W.W.W.FW.WW.WWF.FW
W.W.W.......W.W....W
W.W.WFW..WW.W.W.F..W
W.F.W.WWWWW.F.W.WWWW
W.........W...W....W
W.W.W.WW.WWW.WWWW.WW
W.WWWWWW.WWW.W.WW.WW
W....F...WW....F...W
W.WWWWWW....F.WWW..W
W.W...W..WW.W.W....W
W.W.W.W.FWW.W.W.FWWW
W.W.W.....F.W.FP..WW
W.W.WFW..WW.W...W..W
W.F.W.WWWW..WWF.WW.W
W........F........EW
WWWWWWWWWWWWWWWWWWWW
